Billie Eilish - wish you were gay
Ariana Grande - 7 rings
Taylor Swift - You Need To Calm Down
Camila Cabello - Liar
Halsey - Graveyard
Lady Gaga - Always Remember Us This Way
Beyoncé - Formation
Rihanna - Don't Stop The Music
Cardi B, Bad Bunny & J Balvin - I Like It
Dua Lipa - Don't Start Now
KAROL G - Ocean
Selena Gomez - Lose You To Love Me
Sia - Chandelier
Nicki Minaj - MEGATRON
Bebe Rexha - Last Hurrah
Lana Del Rey - Doin' Time
Katy Perry - Never Really Over
Miley Cyrus - Slide Away
P!nk - Walk Me Home
Lizzo - Juice
Anitta - Juego
Adele - Rolling in the Deep
BLACKPINK - Kill This Love
Demi Lovato - Sorry Not Sorry
Ellie Goulding - Sixteen
Rita Ora - Let You Love Me
Anne-Marie - 2002
Marília Mendonça - Serenata (Ao Vivo)
Shakira, Freshlyground - Waka Waka (This Time for Africa)
Becky G - 24/7
Natti Natasha - Oh Daddy
Little Mix - Black Magic
Ava Max - So Am I
Julia Michaels - 17
Clean Bandit - Solo feat. Demi Lovato
Normani - Motivation
ROSALÍA - A Palé
Fleetwood Mac - Little Lies
Kehlani - Feels
Zara Larsson - All the Time
Mabel - Don't Call Me Up
Alessia Cara - Ready
Hailee Steinfeld - Back to Life
Whitney Houston - My Love Is Your Love
Jess Glynne - I'll Be There
Britney Spears - Toxic
TWICE - Feel Special
SZA - The Weekend
Madonna - Hung Up
The Black Eyed Peas - I Gotta Feeling