Ariana Grande - God is a woman
Childish Gambino - Summertime Magic
Twenty One Pilots - Jumpsuit
Twenty One Pilots - Nico And The Niners
Benny blanco - Eastside (with Halsey & Khalid)
Eric Church - Desperate Man
YBN Cordae - Kung Fu
Childish Gambino - Feels Like Summer
Galantis - Satisfied (feat. MAX)
Chantel Jeffries - Both Sides
MÃ˜ - Sun In Our Eyes
Mac Miller - Self Care
Amy Shark - All Loved Up
Louis The Child - The City (with Quinn XCII)
Juice WRLD - Wasted (feat. Lil Uzi Vert)
Alice Gray - Lay Down
BROCKHAMPTON - 1999 WILDFIRE
Dirty Projectors - I Feel Energy (feat. Amber Mark)
Tash Sultana - Harvest Love
Sleepwalkers - Wake Up
Sigrid - Schedules
Channel Tres - Jet Black
Black Atlass - Fantasy
Sophia Scott - White Fence
Buddy - Trippin' (feat. Khalid)
Martin Jensen - 16 Steps
Galantis - Mama Look At Me Now
Wiz Khalifa - Rolling Papers 2
Chris Lane - New Phone, Who's This
Mary J. Blige - Only Love
Jacob Banks - In The Name Of Love - From The Motion Picture The Equalizer 2
Lori McKenna - The Lot Behind St. Mary's
Alessia Cara - A Little More
Lauren Duski - Costume Party
Jocelyn Alice - Still Wondering
Kim Viera - Como
RL Grime - Pressure
Terror Jr - Heaven Wasn't Made For Me
ROZES - Numbed Up
Patrick Droney - Stand and Deliver
Anderson .Paak - Bubblin (feat. Busta Rhymes) - Remix
Mikey Mike - Cooler
Rich The Kid - Leave Me
The Vamps - Talk Later
Tinashe - Like I Used To
Ruston Kelly - Mockingbird
Garren Sean - Sundripcherryswell
Denzel Curry - CLOUT COBAIN | CLOUT CO13A1N
The Lumineers - Visions Of China
Deadmau5 - Monophobia
Lauren Daigle - You Say
FRND - Erase - FRND x Lights Remix
DREAMERS - Black & White
Colin Magalong - Wish I Could
DJ Snake - Maradona Riddim
Good Charlotte - Shadowboxer
Sarah Reeves - Just Want You
Kenny Chesney - Better Boat (feat. Mindy Smith)
Cam - Road To Happiness
Manchester Orchestra - The Gold - Phoebe Bridgers Version
Stars Go Dim - You Know Me Better
Baauer - 3AM
Meg Myers - Tourniquet
I Do - Woke Up In Kingston
T-Shyne - Side Steppin' (feat. Young Thug)
Chief Keef - Uh Uh (feat. Playboi Carti)
Tunde Olaniran - I'm Here
Delaney Jane - L.U.I
HOLYCHILD - Wishing You Away
Cole Swindell - Love You Too Late
Steve Void - Crooked
Jade Novah - Intuition
Wet - 11 Hours
The Internet - La Di Da
Alex Da Kid - Go 2.0 (feat. Jorja Smith, H.E.R. and Rapsody)
Fabolous - Ooh Yea (feat. Ty Dolla $ign)
Howard - Your Honor
Real Friends - Composure
Norah Jones - It Was You
Dillon Francis - Never Let You Go
Lil' Kim - Nasty One
Hearts & Colors - Lucky Man
SKOLES - Am I Going Too Crazy?
The Devil Makes Three - Bad Idea
Parcels - Bemyself
Black Caviar - Killa Shit Funk (feat. G.L.A.M.)
CVBZ - 2 Gone
Ghosted - Hit The Lights
Toast - Scarlett
Andreas Moss - Kokain
Rhye - A Whiter Shade Of Pale - Recorded at Spotify Studios NYC
Cigarettes After Sex - Sesame Syrup
All Saints - Don't Look Over Your Shoulder
Kodaline - Shed a Tear
Tyron Hapi - About You
First Aid Kit - Running Up That Hill - Recorded at Spotify Studios Stockholm